10000
5
redtower greentower bluetower
mudtrap lavatrap
5
1 redcreep redcreep redcreep redcreep redcreep redcreep redcreep redcreep redcreep redcreep redcreep redcreep redcreep redcreep redcreep
1 yellowcreep yellowcreep yellowcreep
1 bluecreep
1 redcreep
2 redcreep
36 33 0 3
000000000000000000000000000000000000
000000000000000000000000000000000000
222222200222222222222222222222222222
222223200232222222222222222222222223
222222200222222222222222222222222222
000022200222000000000000000000000000
000022200222000000000000000000000000
000022200222001111111111111111111111
000022200222001111111111111111111111
000022200222001111111111111111111111
000022200222001111111111111111111111
000022200222000000000000000000000000
000022200222000000000000000000000000
000022200222000000000000000000000000
000022200222000000000000000000000000
000022200222000000000000000000000000
000022200222000000000000000000000000
000022200222222222222222222222222200
000022200232222222222222222222223200
000022200222222222222222222222222200
000022200000000000000000000000022200
000022200000000000000000000000022200
000022200000000000000000000000022200
000022200000000000000000000000022200
000022200000000000000000000000022200
000022200000000000000000000000022200
000022200000000000000000000000022200
000022200000000000000000000000022200
000022222222222222222222222222222200
000023222222222222222222222222223200
000022222222222222222222222222222200
000000000000000000000000000000000000
000000000000000000000000000000000000