36 33
000000000000000000000000000000000000
000000000000000000000000000000000000
111111111000011111111111111111110000
111111111000011111111111111111110000
000000011000011000000000000000110000
000000011000011000000000000000110000
000000011000011000000000000000110000
000000011000011000000000000000111111
000000011000011000000000000000111111
000000011000011000000000000000000000
000000011000011000000000000000000000
000000011000011000000000000000000000
000000011000011000000000000000000000
000000011000011000000000000000000000
000000011000011000000000000000000000
000000011000011000000000000000000000
000000011000011000000000000000000000
000000011000011000000000000000000000
000000011000011000000000000000000000
000000011000011000000000000000000000
000000011000011000000000000000000000
000000011000011000000000000000000000
000000011000011000000000000000000000
000000011000011000000000000000000000
000000011000011000000000000000000000
000000011000011000000000000000000000
000000011000011000000000000000000000
000000011000011000000000000000000000
000000011111111000000000000000000000
000000011111111000000000000000000000
000000000000000000000000000000000000
000000000000000000000000000000000000
000000000000000000000000000000000000