200
5
redtower greentower bluetower
mudtrap lavatrap
10
1 redcreep redcreep redcreep redcreep redcreep redcreep redcreep redcreep redcreep
1 redcreep redcreep redcreep redcreep redcreep redcreep redcreep redcreep redcreep redcreep redcreep yellowcreep
1 yellowcreep yellowcreep yellowcreep yellowcreep yellowcreep
1 bluecreep
3 redcreep redcreep redcreep redcreep redcreep redcreep redcreep redcreep redcreep
3 redcreep redcreep redcreep redcreep redcreep redcreep redcreep redcreep redcreep redcreep redcreep yellowcreep
3 yellowcreep yellowcreep yellowcreep yellowcreep yellowcreep
3 bluecreep
4 redcreep redcreep redcreep redcreep redcreep redcreep redcreep redcreep redcreep redcreep redcreep redcreep redcreep redcreep redcreep redcreep redcreep redcreep redcreep redcreep yellowcreep
5 bluecreep
36 33 0 3
000000000000000000000000000000000000
000000000000000000000000000000000000
222222222222222200000000000000000000
222222222222223200000000000000000000
222222222222222200000000000000000000
000000000000022200000000000000000000
000000000000022200222222222222222222
002222222000022200232222222222222223
002322232000022200222222222222222222
002222222000022200222000000000000000
002220222000022200222000000000000000
002220222000022200222000000000000000
002220222000022200222000000000000000
002220222000022200222000000000000000
002220222100122200222222222222220000
002220222111122200232222222222320000
002220222222222200222222222222220000
002220232222223200000000000012220000
002220222222222200000000000012220000
002221000000000000000000000012220000
002221000000000000000000000012220000
002221000000000000000000000012220000
002221000000000000000000000012220000
002221000000000000000000000012220000
002221000000000000000000000012220000
002221000000000000000000000012220000
002221000000000000000000000012220000
002221111111111111111111111112220000
002222222222222222222222222222220000
002322222222222222222222222222320000
002222222222222222222222222222220000
000000000000000000000000000000000000
000000000000000000000000000000000000