100
10
greentower
mud
5
1 redcreep redcreep redcreep redcreep redcreep redcreep redcreep redcreep redcreep redcreep redcreep redcreep redcreep redcreep redcreep
2 redcreep redcreep redcreep redcreep redcreep redcreep redcreep redcreep redcreep redcreep redcreep redcreep redcreep redcreep redcreep
3 redcreep redcreep redcreep redcreep redcreep redcreep redcreep redcreep redcreep redcreep redcreep redcreep redcreep redcreep redcreep
4 redcreep redcreep redcreep redcreep redcreep redcreep redcreep redcreep redcreep redcreep redcreep redcreep redcreep redcreep redcreep
5 redcreep redcreep redcreep redcreep redcreep redcreep redcreep redcreep redcreep redcreep redcreep redcreep redcreep redcreep redcreep
36 33 0 21
000000000000000000000000000000000000
000000000000000000000000000000000000
000000000022222220000000000222222222
000000000023222320000000000232222223
000000000022222220000000000222222222
000000000022202220000000000222000000
000000000022202220000000000222000000
000000000022202220000000000222000000
000000000022202220000000000222000000
000000000022202220000000000222000000
000000000022202220000000000222000000
000000000022202220000000000222000000
000000000022202220000022222222000000
000000000022202220000023222232000000
000000000022202220000022222222000000
000000000022202220000022200000000000
000000000022202220000022200000000000
000000000022202220000022200000000000
000000000022202220000022200000000000
000000000022202220000022200000000000
222222222222202220000022200000000000
222222222223202220000022200000000000
222222222222202220000022200000000000
000000000000002220000022200000000000
000000000000002220000022200000000000
000022222222222220000022200000000000
000023222222222320000022200000000000
000022222222222220000022200000000000
000022200000000000000022200000000000
000022222222222222222222200000000000
000023222222222222222223200000000000
000022222222222222222222200000000000
000000000000000000000000000000000000