200
15
redtower greentower
3
redcreep redcreep redcreep  redcreep  redcreep  redcreep  redcreep  redcreep  redcreep  redcreep  yellowcreep yellowcreep yellowcreep
redcreep redcreep redcreep redcreep redcreep redcreep redcreep redcreep  redcreep  redcreep  redcreep  redcreep  redcreep  redcreep  redcreep  yellowcreep yellowcreep yellowcreep yellowcreep yellowcreep yellowcreep yellowcreep
yellowcreep yellowcreep yellowcreep yellowcreep yellowcreep yellowcreep yellowcreep yellowcreep yellowcreep yellowcreep yellowcreep yellowcreep yellowcreep yellowcreep yellowcreep yellowcreep yellowcreep yellowcreep yellowcreep yellowcreep
36 33 0 3
000000000000000000000000000000000000
000000000000000000000000000000000000
111111111000011111111111111111110000
111111121000012111111111111111210000
111111111000011111111111111111110000
000000111000011100000000000001110000
000000111000011100000000000001110000
000000111000011100000000000001111111
000000111000011100000000000001211112
000000111000011100000000000001111111
000000111000011100000000000000000000
000000111000011100000000000000000000
000000111000011100000000000000000000
000000111000011100000000000000000000
000000111000011100000000000000000000
000000111000011100000000000000000000
000000111000011100000000000000000000
000000111000011100000000000000000000
000000111000011100000000000000000000
000000111000011100000000000000000000
000000111000011100000000000000000000
000000111000011100000000000000000000
000000111000011100000000000000000000
000000111000011100000000000000000000
000000111000011100000000000000000000
000000111000011100000000000000000000
000000111000011100000000000000000000
000000111000011100000000000000000000
000000111111111100000000000000000000
000000121111112100000000000000000000
000000111111111100000000000000000000
000000000000000000000000000000000000
000000000000000000000000000000000000
