32 32
00000000000000000000000000000000
00000000000000000000000000000000
11111111100001111111111111111111
11111111100001111111111111111111
00000001100001100000000000000000
00000001100001100000000000000000
00000001100001100000000000000000
00000001100001100000000000000000
00000001100001100000000000000000
00000001100001100000000000000000
00000001100001100000000000000000
00000001100001100000000000000000
00000001100001100000000000000000
00000001100001100000000000000000
00000001100001100000000000000000
00000001100001100000000000000000
00000001100001100000000000000000
00000001100001100000000000000000
00000001100001100000000000000000
00000001100001100000000000000000
00000001100001100000000000000000
00000001100001100000000000000000
00000001100001100000000000000000
00000001100001100000000000000000
00000001100001100000000000000000
00000001100001100000000000000000
00000001100001100000000000000000
00000001100001100000000000000000
00000001111111100000000000000000
00000001111111100000000000000000
00000000000000000000000000000000
00000000000000000000000000000000