36 33 0 3
000000000000000000000000000000000000
000000000000000000000000000000000000
111111111000011111111111111111110000
222222221000012222222222222222210000
111111121000012111111111111111210000
000000121000012100000000000001210000
000000121000012100000000000001210000
000000121000012100000000000001211111
000000121000012100000000000001222222
000000121000012100000000000001111111
000000121000012100000000000000000000
000000121000012100000000000000000000
000000121000012100000000000000000000
000000121000012100000000000000000000
000000121000012100000000000000000000
000000121000012100000000000000000000
000000121000012100000000000000000000
000000121000012100000000000000000000
000000121000012100000000000000000000
000000121000012100000000000000000000
000000121000012100000000000000000000
000000121000012100000000000000000000
000000121000012100000000000000000000
000000121000012100000000000000000000
000000121000012100000000000000000000
000000121000012100000000000000000000
000000121000012100000000000000000000
000000121000012100000000000000000000
000000121111112100000000000000000000
000000122222222100000000000000000000
000000111111111100000000000000000000
000000000000000000000000000000000000
000000000000000000000000000000000000
