36 33 0 21
000000000000000000000000000000000000
000000000000000000000000000000000000
000000000011111110000000000111111111
000000000012111210000000000121111112
000000000011111110000000000111111111
000000000011101110000000000111000000
000000000011101110000000000111000000
000000000011101110000000000111000000
000000000011101110000000000111000000
000000000011101110000000000111000000
000000000011101110000000000111000000
000000000011101110000000000111000000
000000000011101110000011111111000000
000000000011101110000012111121000000
000000000011101110000011111111000000
000000000011101110000011100000000000
000000000011101110000011100000000000
000000000011101110000011100000000000
000000000011101110000011100000000000
000000000011101110000011100000000000
111111111111101110000011100000000000
111111111112101110000011100000000000
111111111111101110000011100000000000
000000000000001110000011100000000000
000000000000001110000011100000000000
000011111111111110000011100000000000
000012111111111210000011100000000000
000011111111111110000011100000000000
000011100000000000000011100000000000
000011111111111111111111100000000000
000012111111111111111112100000000000
000011111111111111111111100000000000
000000000000000000000000000000000000