36 33
000000000000000000000000000000000000
000000000000000000000000000000000000
111111111000011111111111111111110000
111111111000011111111111111111110000
111111111000011111111111111111110000
000000111000011100000000000001110000
000000111000011100000000000001110000
000000111000011100000000000001111111
000000111000011100000000000001111111
000000111000011100000000000001111111
000000111000011100000000000000000000
000000111000011100000000000000000000
000000111000011100000000000000000000
000000111000011100000000000000000000
000000111000011100000000000000000000
000000111000011100000000000000000000
000000111000011100000000000000000000
000000111000011100000000000000000000
000000111000011100000000000000000000
000000111000011100000000000000000000
000000111000011100000000000000000000
000000111000011100000000000000000000
000000111000011100000000000000000000
000000111000011100000000000000000000
000000111000011100000000000000000000
000000111000011100000000000000000000
000000111000011100000000000000000000
000000111000011100000000000000000000
000000111111111100000000000000000000
000000111111111100000000000000000000
000000111111111100000000000000000000
000000000000000000000000000000000000
000000000000000000000000000000000000
